BBBBBBBBBBMBBBBBBBBBBBBB
BBBMBBBBBBBBBBBBBBBBBBBB
BBBBBBBBBBBBBBBBBBBMBBBB
BBBBPPPPPPPPPPPPPPPPBBBB
BBBBPPPPPPPPPPPPPPPPBBBB
BBBBBBBBBBBBBBBPPPPBBBBB
BBBBBBBBJBBBBPPPPBBBBBBB
BBBBBBBBBBBPPPPBBBBBBBBB
BBBBBBBBBPPPPBBBBBBBBBBB
BBBBBBBPPPPBBBBBMBBBBBBB
BBBBBPPPPBBBBBBBBBBBBBBB
BBBBPPPPPPPPPPPPPPPPBBBB
BBBBPPPPPPPPPPPPPPPPBBBB
BBBBBBBBBBBMBBBBBBBBBBBB
BBBBBMBBBBBBBBBBBBMBBBBB
BBBBBBBBBBBBBBBBBBBBBBBB