BBBBBBBBBBBBBBBBBBBBBBBB
BBBBBBBMBBBBBBBBBBBBBBJB
BBBBBBBBBBBBBBBBBBBBBBBB
BBBBBPPPPPPPPPPPBBBBBBBB
BBBBBPPPPPPPPPPPBBBBBBBB
BBBBBPPBBMBBBBBBBBBBBBBB
BBBMBPPBBBBBBBBBBBBBBBBB
BBBBBPPPPPPPPBBBBBBBBBBB
BBBBBPPPPPPPPBBBBBBBBBBB
BBBBBPPBBBBBBBBBBBMBBBBB
BBMBBPPBBMBBBBBBBBBBBBBB
BBBBBPPBBBBBBBBBBBBBBBBB
BBBBBPPBBBBBBBBBBBBBBBBB
BBBBBBBBBBBBBBBBBMBBBBBB
BBBMBBBBBMBBBBBBBBBBBBBB
BBBBBBBBBBBBBBBBBBBBBBBB