BBBBBBBBBBBBBBBBBBBBBBBB
BBMBBBBBBBBBBBBBBBBBBBMB
BBBBBBBBBBBBBBBBBBBBBBBB
BBBBBPPPPBBBBBMBBBPPBBBB
BBBBBPPBPPBBBBBBBBPPBBBB
BBBBBPPBBPPBBBBBBBPPBBBB
BBBBBPPBBBPPBBBBBBPPBBBB
BBBMBPPBBBBPPBBBBBPPBBBB
BBBBBPPBBBBBPPBBBBPPBBMB
BBBBBPPBBBBBBPPBBBPPBBBB
BBBBBPPBBBBBBBPPBBPPBBBB
BBBBBPPBBJBBBBBPPBPPBBBB
BBBBBPPBBBBBBBBBPPPPBBBB
BBBBBBBBBBBBBBBBBBBBBBBB
BBMBBBBBBBBBBBBMBBBBBBBB
BBBBBBBBBBBBBBBBBBBBBBBB