BBBBBBBBBBMBBBBBBBBBBBBB
BBBMBBBBBBBBBBBBBBBBBBBB
BBBBBBBBBBBBBBBBBBBMBBBB
BBBBPPPPPPPPPPPPPPPPBBBB
BBBBPPPPPPPPPPPPPPPPBBBB
BBBBBBBBBBPPPPBBBBBBBBBB
BBBBBMBBBBPPPPBBBBBBBBBB
BBBBBBBBBBPPPPBBBBBBBBBB
BBBBBBBBBBPPPPBBBBJBBBBB
BBBMBBBBBBPPPPBBBBBBBBBB
BBBBBBBBBBPPPPBBBBBBBBBB
BBBBPPPPPPPPPPPPPPPPBBBB
BBBBPPPPPPPPPPPPPPPPBBBB
BBBBBBBBBBBMBBBBBBBBBBBB
BBBBBMBBBBBBBBBBBBMBBBBB
BBBBBBBBBBBBBBBBBBBBBBBB