BBBBBBBBBBBBBBBBBBBBBBBB
BBBBBMBBBBBBBBBBBPPPPBBB
BBBBBBBBBBBBBBMBBPBBBBBB
BBBBBBBBBBBBBBBBPPBBBBBB
BBBBBBBBBBBBBBPPPBBBBBBB
BBBBBBBBBBBPPPPBBBBBBBBB
BBBBBBBBBBBBBBBBBBMBBBBB
BBBBBBBBBBBBBBBBBBBBBBBB
BBBBBBBBBBBBBBBMBBBBBBBB
BBBBBBBBBBBPBBBBBBBBBBBB
BBBMBBBBBBBPBBBBBBBBBBBB
BBBBBBBBBBBPBBBBBBBBBBBB
BBBBBBBBBBBBBPPPPPPPPPPP
BBBBMBBBBBBBBBBBBBBBBBBB
BBBBBBBBBBBBBBBBBBBJBBBB
BBBBBBBBBBBBBBBBBBBBBBBB