BBBBBBBBBBBBBBBBBBBBBBBB
BBBBBBBBBBBBBBBBBPPPPBBB
BBBBBBBBBBBBBBBBBPBBBBBB
BBBBBBBBBBBBBBBBPPBBBBBB
BBBBBBBBBBBBBBPPPBBBBBBB
BBBBBBBBBBBPPPPBBBBBBBBB
BBBBBBBBBBBBBBBBBBBBBBBB
BBJBBBBBBBBBBBBBBBBBBBBB
BBBBBBBBBBBBBBBMBBBBBBBB
BBBBBBBBBBBPBBBBBBBBBBBB
BBBBBBBBBBBPBBBBBBBBMBBB
BBBBBBBBBBBPBBBBBBBBBBBB
PPPPPPPPPPPPBBBBBBBBBBBB
BBBBBBBBBBBBBBBBBBBBBBBB
BBBBBBBBBBBBBMBBBBBBBBBB
BBBBBBBMBBBBBBBBBMBBBBBB